でゅるわぁあああああぶるわっひゃあひゃひゃひゃひゃどぅるわっはあああああああああぎゃあああああうわああああああああ	でゅるわぁあああああぶるわっひゃあひゃひゃひゃひゃどぅるわっはあああああああああぎゃあああああうわああああああああ	名詞	
くりすます	クリスマスも、あなたの松来未祐です。	名詞	
ねんまつちょうせい	いえーいシンシアリー松来は領収書の整理がやっと終わってやっと自炊に戻れそうだよいぇいいぇーい	名詞	
いえーい	いえーい松ちゃんだよー	名詞	
みなさま	みなさまこんにちは。お蕎麦屋さんなうシンシアリー松来です。	名詞	
そば	みなさまこんにちは。お蕎麦屋さんなうシンシアリー松来です。	名詞	
そば	いま、近くの席であたたかいお蕎麦を食べ終わったお婆様に、二杯目のお蕎麦が運ばれてきて、驚愕のツイートに参りました。	名詞	
いま	いま、近くの席であたたかいお蕎麦を食べ終わったお婆様に、二杯目のお蕎麦が運ばれてきて、驚愕のツイートに参りました。	名詞	
そば	負けるわけにはいきません。今から鴨せいろなうです。ちなみにお婆様の二杯目は天ぷら蕎麦でした。みなさま、それではまた！	名詞	
まけるわけにはいきません	負けるわけにはいきません。今から鴨せいろなうです。ちなみにお婆様の二杯目は天ぷら蕎麦でした。みなさま、それではまた！	名詞	
ばれんたいん	いつも応援してくれるシンシアラーの皆さんへ。松来未祐さんからバレンタインチョコレートフォトが届きました。(^_^)v（寝ポテの収録現場にて）【スタッフ】 http://t.co/BfSKHWjigi	名詞	
いつもおうえん	いつも応援してくれるシンシアラーの皆さんへ。松来未祐さんからバレンタインチョコレートフォトが届きました。(^_^)v（寝ポテの収録現場にて）【スタッフ】 http://t.co/BfSKHWjigi	名詞	
といれ	そして朝方四時に目が覚め下しまくり、トイレでずっと「くだ…しんしありー…うん…ツイッターに…使える…」とほくそ笑む松来未祐でした。	名詞	
そして	そして朝方四時に目が覚め下しまくり、トイレでずっと「くだ…しんしありー…うん…ツイッターに…使える…」とほくそ笑む松来未祐でした。	名詞	
あ	あ、お食事中の方、すみません。	名詞	
おしょくじちゅう	あ、お食事中の方、すみません。	名詞	
すみません	あ、お食事中の方、すみません。	名詞	
いえーい	いえーい	名詞	
まつきさんにははやくけっこんしてほしい	
まつらいさんにははやくけっこんしてほしい	
まつらいさん	松来さん	名詞	
まつらいさん	松来未祐	名詞	
まつき	松来未祐	名詞	
まつき	まつらいさん	名詞	