あ	ぁ	名詞	ギャルゴリラ文字
い	ﾚヽ	名詞	ギャルゴリラ文字
う	ぅ	名詞	ギャルゴリラ文字
え	ぇ	名詞	ギャルゴリラ文字
お	ぉ	名詞	ギャルゴリラ文字
か	ヵゝ	名詞	ギャルゴリラ文字
き	(≠	名詞	ギャルゴリラ文字
く	＜	名詞	ギャルゴリラ文字
け	ﾚﾅ	名詞	ギャルゴリラ文字
こ	⊇	名詞	ギャルゴリラ文字
さ	±	名詞	ギャルゴリラ文字
し	Ｕ	名詞	ギャルゴリラ文字
す	￡	名詞	ギャルゴリラ文字
せ	世	名詞	ギャルゴリラ文字
そ	ξ	名詞	ギャルゴリラ文字
た	T=	名詞	ギャルゴリラ文字
ち	ち	名詞	ギャルゴリラ文字
つ	⊃	名詞	ギャルゴリラ文字
て	τ	名詞	ギャルゴリラ文字
と	`⊂	名詞	ギャルゴリラ文字
な	Tょ	名詞	ギャルゴリラ文字
に	ﾚﾆ	名詞	ギャルゴリラ文字
ぬ	йu	名詞	ギャルゴリラ文字
ね	Йё	名詞	ギャルゴリラ文字
の	σ	名詞	ギャルゴリラ文字
は	ﾚ￡	名詞	ギャルゴリラ文字
ひ	ひ	名詞	ギャルゴリラ文字
ふ	､ζ,	名詞	ギャルゴリラ文字
へ	∧	名詞	ギャルゴリラ文字
ほ	ﾚま	名詞	ギャルゴリラ文字
ま	ма	名詞	ギャルゴリラ文字
み	ゐ	名詞	ギャルゴリラ文字
む	￡ヽ	名詞	ギャルゴリラ文字
め	め	名詞	ギャルゴリラ文字
も	м○	名詞	ギャルゴリラ文字
や	ゃ	名詞	ギャルゴリラ文字
ゆ	ゅ	名詞	ギャルゴリラ文字
よ	ょ	名詞	ギャルゴリラ文字
わ	ゎ	名詞	ギャルゴリラ文字
を	を	名詞	ギャルゴリラ文字
ん	ω	名詞	ギャルゴリラ文字
まじ	まぢ	名詞	ギャルゴリラ文字
