うるさいばばあだ	・・・うるさいババアだ！	名詞	ジャック・アトラス
けっ	(((┗─y(｀A´)y-~ｹｯ!!	顔文字	ラブライブ。矢澤にこが華麗で高速なキータイプをして書き込んだ一行AA。あまりに高速でどうやって入力したのかはよくわからない。Shiftキーとの同時押し等は超瞬間的に行われていたか、そんな概念のないキーボードだ
かわいく	（※かわいく）	名詞	ラ・プチミレディオ#37
あいどるますたー	#imas	名詞	
ねぎま	#negima	名詞	魔法先生ネギま！
ぷちみれでぃお	#petitmiradio	名詞	ラジオ実況用。Twitterハッシュタグ。
ぷりきゅあ	#precure	名詞	プリキュア
ぷりてぃりずむ	#prettyrhythm	名詞	プリティーリズム
ぷりぱら	#pripara	名詞	プリパラ
さき	#saki	名詞	
わーきんぐ	#wagnaria	名詞	WORKING!!
ゆるゆり	#yuruyuri	名詞	ゆるゆり
ゆゆしき	#yuyushiki	名詞	ゆゆ式
さいだーおじさん	100%サイダーおじさん	固有名詞	碧と彩奈のラ・プチミレディオ #31 で100%サイダーガールと間違えて放送された歌のタイトルまたは歌う人。19:20あたりで初登場。覇気のないねっとり声で歌うおじさんっぽくないおじさん。ちらちらぅうぉっちん。
まって	MA☆TTE!!	名詞	ジャック・アトラス
ぷちみれでぃ	petit milady	名詞	
すたでぃあっぷこいごころ	Study up !! ٩(ˊᗜˋ*)و 恋心っ！♥ So we are 恋愛ラボッ！(๑>◡<๑) まだლ(´ڡ`ლ)？ まだっ╭( ･ㅂ･)و！ み～えないラヴ！✲ﾟ｡.(✿╹◡╹)ﾉ☆.｡₀:*ﾟ✲ﾟ*:₀｡ ねぇ、もっと知りたいね！(∩*´ω`*∩)♪	名詞	
れんあいらぼ	Study up !! ٩(ˊᗜˋ*)و 恋心っ！♥ So we are 恋愛ラボッ！(๑>◡<๑) まだლ(´ڡ`ლ)？ まだっ╭( ･ㅂ･)و！ み～えないラヴ！✲ﾟ｡.(✿╹◡╹)ﾉ☆.｡₀:*ﾟ✲ﾟ*:₀｡ ねぇ、もっと知りたいね！(∩*´ω`*∩)♪	名詞	
あ	あぁ^～心がぴょんぴょんするんじゃぁ^～	名詞	ご注文はうさぎですか？
あぁ	あぁ^～心がぴょんぴょんするんじゃぁ^～	名詞	ご注文はうさぎですか？
ああ	あぁ^～心がぴょんぴょんするんじゃぁ^～	名詞	ご注文はうさぎですか？
いんちき	インチキ効果もいい加減にしろ！	名詞	クロウ・ホーガン
うめはら	ウメハラがぁ！！！捕まえてぇぇ！！！ウメハラがぁ！画面端ぃぃっ！！！！バースト読んでえぇっ！！！まだ入るぅぅ！！ウメハラがぁ！！！！・・・つっ近づいてぇっ！！！ウメハラがぁ決めたぁぁーっ！！！！	名詞	電波実況 「ウメハラがぁっ！！！決めたぁぁーっ！！！！ - ニコニコ動画:GINZA http://www.nicovideo.jp/watch/sm5941
おれにあったしごと	オレに合った仕事がない以上、仕方あるまい！	名詞	ジャック・アトラス
くらすないひえらるきー	クラス内ヒエラルキーそう誰が決めたわけでもなくいつの間にか作り上げられる1軍2軍3軍 全てにおいて中の下から中の上妄想社会で毎日ワーキャー1軍になりたいわけでもないそんな私たちは2軍のファンタジスタであーる	名詞	GJ部。OP。「もうそう☆こうかんにっき」の冒頭。
けーきけーきまぁるいけーきはだあれ	ケーキ、ケーキ、まぁるいケーキ まぁるいケーキはだぁれ？	名詞	Next:けーきはさやか
けーきはさやか	ケーキハサヤカ？ ちーがーう 私はラズベリー まぁるいケーキはあーかい	名詞	Next:けーきはあんず
けーきはまどか	ケーキはまどか？ ちーがーう わたしはメロン メロンが割れたら甘い夢	名詞	Next:こんやのおゆめは
けーきはまみ	ケーキはマミ？ ちーがーう 私はチーズ まぁるいケーキは転がる	名詞	Next:けーきはあけみさん
けーきはあんず	ケーキは杏子？ ちーがーう あたしはリンゴ まぁるいケーキはベベが好き	名詞	Next:けーきはまみ
けーきはあけみさん	ケーキは暁美さん？ ちがっ……います 私はかぼちゃ まぁるいケーキは甘いです	名詞	Next:けーきはまどか
ぷちみれ	ないことがあるように運命とは、避けがたく、時にはかないもの	名詞	
にゃんぱす	にゃんぱす〜	名詞	「のんのんびより」に登場する挨拶
ほっぺまっかっかまつりだね	ほっぺ真っ赤っ赤まつりだね	名詞	ラ・プチミレディオ#355
じしん	や、おっぱいは揺れてないからね（笑）	名詞	https://twitter.com/Ayana_take/status/162076119531667457
ゆゆしきさいこう	ゆゆ式最高！ゆゆ式最高！	名詞	三上小又(@mikamikomata)による日本の4コマ漫画作品。2013年4-6月アニメ放映。
こんやのおゆめは	今夜のお夢は苦い夢 お皿の上には猫の夢 丸々太って召し上がれー！	顔文字	魔法少女まどか☆マギカ 劇場版「叛逆の物語」
わたししゅやくのあかざあかりです	私、主役の赤座あかりです/あかり	名詞	